{
  "name": "Classic",
  "maxGameDuration": 150,
  "gameMap": [["#", "#", "#", "#", "#", "#", "#", "#", "#", "#", "#", "#", "#", "#", "#", "#", "#", "#", "#", "#", "#", "#", "#", "#", "#", "#", "#", "#"],
              ["#", "p", ".", ".", ".", ".", ".", ".", ".", ".", ".", ".", ".", "#", "#", ".", ".", ".", ".", ".", ".", ".", ".", ".", ".", ".", ".", "#"],
              ["#", ".", "#", "#", "#", "#", ".", "#", "#", "#", "#", "#", ".", "#", "#", ".", "#", "#", "#", "#", "#", ".", "#", "#", "#", "#", ".", "#"],
              ["#", ".", "#", "#", "#", "#", ".", "#", "#", "#", "#", "#", ".", "#", "#", ".", "#", "#", "#", "#", "#", ".", "#", "#", "#", "#", ".", "#"],
              ["#", ".", "#", "#", "#", "#", ".", "#", "#", "#", "#", "#", ".", "#", "#", ".", "#", "#", "#", "#", "#", ".", "#", "#", "#", "#", ".", "#"],
              ["#", ".", ".", ".", ".", ".", ".", ".", ".", ".", ".", ".", ".", ".", ".", ".", ".", ".", ".", ".", ".", ".", ".", ".", ".", ".", ".", "#"],
              ["#", ".", "#", "#", "#", "#", ".", "#", "#", ".", "#", "#", "#", "#", "#", "#", "#", "#", ".", "#", "#", ".", "#", "#", "#", "#", ".", "#"],
              ["#", ".", "#", "#", "#", "#", ".", "#", "#", ".", "#", "#", "#", "#", "#", "#", "#", "#", ".", "#", "#", ".", "#", "#", "#", "#", ".", "#"],
              ["#", ".", ".", ".", ".", ".", ".", "#", "#", ".", ".", ".", ".", "#", "#", ".", ".", ".", ".", "#", "#", ".", ".", ".", ".", ".", ".", "#"],
              ["#", "#", "#", "#", "#", "#", ".", "#", "#", "#", "#", "#", ".", "#", "#", ".", "#", "#", "#", "#", "#", ".", "#", "#", "#", "#", "#", "#"],
              [" ", " ", " ", " ", " ", "#", ".", "#", "#", "#", "#", "#", ".", "#", "#", ".", "#", "#", "#", "#", "#", ".", "#", " ", " ", " ", " ", " "],
              [" ", " ", " ", " ", " ", "#", ".", "#", "#", ".", ".", ".", ".", ".", ".", ".", ".", ".", ".", "#", "#", ".", "#", " ", " ", " ", " ", " "],
              [" ", " ", " ", " ", " ", "#", ".", "#", "#", ".", "#", "#", "#", "#", "#", "#", "#", "#", ".", "#", "#", ".", "#", " ", " ", " ", " ", " "],
              ["#", "#", "#", "#", "#", "#", ".", "#", "#", ".", "#", " ", " ", " ", " ", " ", " ", "#", ".", "#", "#", ".", "#", "#", "#", "#", "#", "#"],
              [".", ".", ".", ".", ".", ".", ".", ".", ".", ".", "#", " ", " ", " ", " ", " ", " ", "#", ".", ".", ".", ".", ".", ".", ".", ".", ".", "."],
              ["#", "#", "#", "#", "#", "#", ".", "#", "#", ".", "#", " ", " ", " ", " ", " ", " ", "#", ".", "#", "#", ".", "#", "#", "#", "#", "#", "#"],
              [" ", " ", " ", " ", " ", "#", ".", "#", "#", ".", "#", "#", "#", "#", "#", "#", "#", "#", ".", "#", "#", ".", "#", " ", " ", " ", " ", " "],
              [" ", " ", " ", " ", " ", "#", ".", "#", "#", ".", ".", ".", ".", ".", ".", ".", ".", ".", ".", "#", "#", ".", "#", " ", " ", " ", " ", " "],
              [" ", " ", " ", " ", " ", "#", ".", "#", "#", ".", "#", "#", "#", "#", "#", "#", "#", "#", ".", "#", "#", ".", "#", " ", " ", " ", " ", " "],
              ["#", "#", "#", "#", "#", "#", ".", "#", "#", ".", "#", "#", "#", "#", "#", "#", "#", "#", ".", "#", "#", ".", "#", "#", "#", "#", "#", "#"],
              ["#", ".", ".", ".", ".", ".", ".", ".", ".", ".", ".", ".", ".", "#", "#", ".", ".", ".", ".", ".", ".", ".", ".", ".", ".", ".", ".", "#"],
              ["#", ".", "#", "#", "#", "#", ".", "#", "#", "#", "#", "#", ".", "#", "#", ".", "#", "#", "#", "#", "#", ".", "#", "#", "#", "#", ".", "#"],
              ["#", ".", "#", "#", "#", "#", ".", "#", "#", "#", "#", "#", ".", "#", "#", ".", "#", "#", "#", "#", "#", ".", "#", "#", "#", "#", ".", "#"],
              ["#", ".", ".", ".", "#", "#", ".", ".", ".", ".", ".", ".", ".", ".", ".", ".", ".", ".", ".", ".", ".", ".", "#", "#", ".", ".", ".", "#"],
              ["#", "#", "#", ".", "#", "#", ".", "#", "#", ".", "#", "#", "#", "#", "#", "#", "#", "#", ".", "#", "#", ".", "#", "#", ".", "#", "#", "#"],
              ["#", "#", "#", ".", "#", "#", ".", "#", "#", ".", "#", "#", "#", "#", "#", "#", "#", "#", ".", "#", "#", ".", "#", "#", ".", "#", "#", "#"],
              ["#", ".", ".", ".", ".", ".", ".", "#", "#", ".", ".", ".", ".", "#", "#", ".", ".", ".", ".", "#", "#", ".", ".", ".", ".", ".", ".", "#"],
              ["#", ".", "#", "#", "#", "#", "#", "#", "#", "#", "#", "#", ".", "#", "#", ".", "#", "#", "#", "#", "#", "#", "#", "#", "#", "#", ".", "#"],
              ["#", ".", "#", "#", "#", "#", "#", "#", "#", "#", "#", "#", ".", "#", "#", ".", "#", "#", "#", "#", "#", "#", "#", "#", "#", "#", ".", "#"],
              ["#", ".", ".", ".", ".", ".", ".", ".", ".", ".", ".", ".", ".", ".", ".", ".", ".", ".", ".", ".", ".", ".", ".", ".", ".", ".", ".", "#"],
              ["#", "#", "#", "#", "#", "#", "#", "#", "#", "#", "#", "#", "#", "#", "#", "#", "#", "#", "#", "#", "#", "#", "#", "#", "#", "#", "#", "#"]]
}
