{
  "maxGameDuration": 420,
  "gameMap": [["#", ".", "#", ".", ".", ".", ".", "#", "#", ".", ".", "#", "#", "#", "#", "#", ".", "#", ".", "#", ".", "#", ".", ".", "#", "#", "#", "#", "#", "#", "#", ".", ".", ".", "#", "#", "#", "."],
              ["#", "#", "#", "#", ".", "#", "#", "#", "#", ".", ".", ".", ".", ".", ".", "#", ".", ".", ".", "#", ".", "#", ".", "#", "#", ".", "#", ".", ".", ".", "#", ".", "#", ".", "#", ".", ".", "."],
              [".", ".", ".", "#", ".", ".", ".", ".", "#", "#", "#", "#", "#", ".", "#", "#", ".", "#", "#", "#", ".", "#", ".", ".", "#", ".", "#", ".", "#", ".", ".", ".", "#", ".", "#", ".", "#", "."],
              ["#", "#", ".", "#", "#", "#", "#", ".", ".", ".", ".", ".", "#", ".", "#", ".", ".", ".", "#", ".", ".", "#", "#", ".", "#", ".", ".", ".", "#", "#", "#", "#", "#", ".", "#", "#", "#", "."],
              [".", "#", ".", ".", ".", ".", "#", "#", ".", "#", "#", "#", "#", ".", "#", ".", "#", ".", "#", "#", ".", "#", "#", ".", "#", "#", "#", ".", "#", ".", "#", ".", ".", ".", ".", ".", "#", "."],
              [".", "#", "#", "#", ".", "#", "#", "#", ".", "#", ".", ".", "#", ".", "#", ".", "#", ".", ".", "#", ".", "#", ".", ".", ".", ".", "#", ".", "#", ".", "#", "#", "#", "#", "#", "#", "#", "."],
              [".", "#", ".", "#", ".", "#", "#", "#", ".", "#", ".", "#", "#", "#", "#", ".", "#", "#", ".", "#", ".", ".", ".", "#", "#", ".", "#", ".", ".", ".", ".", ".", ".", ".", "#", ".", ".", "."],
              [".", "#", ".", ".", ".", "#", ".", ".", ".", "#", ".", ".", ".", ".", ".", ".", ".", "#", ".", "#", ".", "#", ".", "#", ".", ".", "#", ".", "#", "#", "#", "#", "#", ".", "#", ".", "#", "#"],
              ["#", "#", ".", "#", ".", ".", ".", "#", ".", "#", ".", "#", "#", "#", ".", "#", "#", "#", "#", "#", ".", "#", ".", ".", ".", "#", "#", ".", "#", ".", "#", ".", ".", ".", ".", ".", "#", "."],
              ["#", ".", ".", "#", "#", "#", "#", "#", "#", "#", ".", "#", ".", "#", "#", "#", ".", ".", "#", ".", ".", "#", "#", ".", "#", "#", ".", ".", "#", ".", "#", ".", "#", "#", "#", "#", "#", "."],
              ["#", ".", "#", "#", ".", "#", ".", ".", ".", ".", ".", "#", ".", "#", ".", ".", ".", "#", "#", "#", "#", "#", ".", ".", "#", ".", ".", "#", "#", ".", ".", ".", ".", ".", "#", ".", ".", "."],
              ["#", "#", "#", ".", ".", "#", ".", "#", "#", "#", ".", ".", ".", ".", ".", "#", "#", "#", ".", ".", ".", "#", ".", "#", "#", ".", "#", "#", "#", "#", "#", "#", "#", ".", "#", ".", "#", "."],
              [".", ".", ".", ".", "#", "#", ".", "#", ".", ".", ".", "#", "#", "#", ".", "#", ".", ".", ".", "#", ".", ".", ".", "#", ".", ".", "#", ".", ".", ".", ".", "#", "#", ".", "#", ".", "#", "."],
              ["#", "#", "#", "#", "#", ".", ".", "#", ".", "#", "#", "#", ".", "#", ".", "#", ".", "#", "#", "#", ".", "#", ".", "#", "#", "#", "#", ".", "#", "#", ".", ".", "#", "#", "#", ".", "#", "#"],
              [".", ".", ".", ".", ".", ".", "#", "#", "#", "#", ".", ".", ".", "#", "#", "#", ".", ".", "#", ".", ".", "#", ".", ".", ".", "#", "#", ".", "#", "#", "#", ".", "#", ".", ".", ".", ".", "."],
              ["#", "#", "#", ".", "#", ".", ".", ".", ".", ".", ".", "#", ".", "#", ".", "#", "#", ".", "#", ".", "#", "#", "#", "#", ".", ".", "#", ".", "#", ".", "#", "#", "#", ".", "#", "#", ".", "#"],
              ["#", ".", ".", ".", "#", "#", "#", "#", "#", "#", ".", "#", ".", ".", ".", ".", "#", ".", "#", ".", "#", ".", ".", "#", "#", ".", ".", ".", "#", ".", "#", ".", ".", ".", ".", "#", ".", "#"],
              ["#", "#", ".", "#", "#", ".", ".", ".", ".", "#", ".", "#", ".", "#", "#", ".", "#", ".", "#", "#", "#", "#", ".", "#", "#", "#", "#", "#", "#", ".", "#", ".", "#", "#", "#", "#", "#", "#"],
              [".", "#", ".", ".", ".", ".", "#", "#", "#", "#", "#", "#", "#", "#", ".", ".", "#", ".", "#", ".", "#", ".", ".", ".", ".", "#", "#", ".", ".", ".", ".", ".", "#", ".", ".", ".", ".", "."],
              ["#", "#", "#", ".", "#", "#", "#", ".", ".", ".", "#", ".", ".", ".", ".", "#", "#", "#", "#", ".", "#", "#", "#", "#", ".", ".", ".", ".", "#", "#", "#", "#", "#", ".", "#", "#", ".", "#"],
              ["#", ".", "#", ".", ".", ".", ".", ".", "#", "#", "#", "#", "#", "#", "#", "#", ".", "#", "#", ".", ".", ".", ".", ".", ".", "#", ".", "#", "#", ".", ".", ".", "#", ".", ".", "#", ".", "#"],
              [".", ".", ".", ".", "#", "#", "#", "#", "#", "#", ".", ".", ".", ".", ".", "#", ".", ".", "#", "#", "#", "#", ".", "#", "#", "#", ".", ".", ".", ".", "#", "#", "#", "#", ".", "#", "#", "#"],
              [".", "#", "#", "#", "#", ".", "#", ".", "#", ".", ".", "#", "#", "#", ".", "#", "#", ".", ".", "#", ".", "#", ".", ".", ".", "#", "#", ".", "#", "#", "#", ".", ".", "#", ".", ".", ".", "."],
              ["#", "#", ".", ".", ".", ".", ".", ".", "#", ".", "#", "#", ".", "#", ".", ".", "#", "#", ".", "#", ".", "#", ".", "#", ".", ".", "#", ".", "#", "#", ".", ".", "#", "#", "#", "#", "#", "#"],
              [".", "#", ".", "#", "#", "#", "#", ".", ".", ".", "#", "#", ".", "#", "#", ".", "#", "#", ".", "#", ".", "#", "#", "#", ".", "#", ".", ".", ".", "#", ".", "#", "#", ".", "#", ".", ".", "."],
              ["#", "#", ".", ".", "#", ".", "#", ".", "#", ".", ".", "#", ".", ".", ".", ".", "#", ".", ".", "#", ".", ".", "#", ".", ".", "#", ".", "#", ".", ".", ".", ".", ".", ".", ".", ".", "#", "."],
              [".", "#", "#", ".", ".", ".", ".", ".", "#", "#", "#", "#", ".", "#", "#", "#", "#", ".", "#", "#", ".", ".", "#", "#", ".", "#", ".", "#", ".", "#", "#", "#", ".", "#", "#", ".", "#", "#"],
              [".", "#", "#", "#", ".", "#", ".", "#", "#", ".", "#", ".", ".", "#", ".", ".", ".", ".", ".", "#", "#", ".", ".", "#", ".", "#", ".", "#", "#", "#", ".", ".", ".", "#", ".", ".", "#", "."],
              [".", ".", ".", "#", "#", "#", ".", ".", "#", ".", "#", ".", "#", "#", ".", "#", ".", "#", ".", "#", "#", "#", ".", "#", ".", "#", ".", "#", ".", "#", ".", "#", "#", "#", "#", ".", "#", "."],
              ["#", ".", "#", "#", ".", "#", ".", "#", "#", ".", "#", ".", ".", "#", ".", "#", ".", "#", ".", "#", ".", ".", ".", "#", "#", "#", ".", "#", ".", "#", ".", "#", ".", ".", ".", ".", ".", "."],
              ["#", ".", "#", "#", ".", ".", ".", "#", "#", ".", "#", "#", ".", "#", ".", "#", ".", "#", ".", "#", ".", "#", ".", "#", ".", ".", ".", "#", ".", ".", ".", "#", "#", ".", "#", "#", "#", "#"],
              ["#", ".", ".", "#", ".", "#", "#", "#", ".", ".", ".", ".", ".", "#", "#", "#", ".", "#", ".", ".", ".", "#", ".", "#", "#", ".", "#", "#", ".", "#", ".", ".", "#", "#", "#", ".", ".", "."],
              ["#", ".", "#", "#", "#", "#", ".", "#", ".", "#", "#", "#", ".", "#", "#", ".", ".", "#", ".", "#", "#", "#", ".", ".", "#", ".", "#", "#", ".", "#", "#", ".", "#", "#", ".", ".", "#", "."],
              ["#", "#", "#", ".", "#", ".", ".", "#", ".", "#", ".", "#", ".", "#", "#", ".", "#", "#", ".", "#", ".", "#", "#", ".", ".", ".", "#", ".", ".", ".", "#", "#", "#", ".", ".", "#", "#", "."],
              ["#", "#", ".", ".", ".", ".", "#", ".", ".", "#", ".", "#", ".", "#", "#", ".", "#", ".", ".", "#", ".", ".", ".", ".", "#", ".", "#", ".", "#", ".", "#", ".", "#", ".", "#", "#", ".", "."],
              ["#", ".", ".", "#", "#", ".", ".", ".", "#", "#", ".", ".", ".", ".", ".", ".", "#", ".", "#", "#", ".", "#", "#", "#", "#", ".", "#", "#", "#", ".", ".", ".", "#", ".", "#", "p", ".", "#"]]
}